NO texture/tile_1.xpm
SO texture/tile_2.xpm
WE texture/tile_3.xpm
EA texture/tile_4.xpm

F 111,111,111
C 50,150,200

           111111
          11000011
       1111000000111
     1110000000000011
    110001111111000011
   1100011     11000011
  1100011       11000011
 1100001         11000011
 1000011          11000011
 110001 11111      1000011
  11011 10001      11000011
   111  10S01       1100001
        1000111    11000011
        11000011  11000011
         1100001111000011
          11000000000011
           110000000111
            111111111