NO texture/tile_1.xpm
SO texture/tile_2.xpm
WE texture/tile_3.xpm
EA texture/tile_4.xpm

F 244,164,96
C 135,206,250

111111111
100000001
100000001
100000001
100000001
100000001
100000001
1000N0001
111111111