NO ./ressources/imgs/north.xpm
SO ./ressources/imgs/south.xpm
WE ./ressources/imgs/west.xpm
EA ./ressources/imgs/east.xpm

C 62,198,247
F 114,114,114


01111111111111111111111111111111111111111111111111111111111111111111111111111111111111111111111111111111111111111111111
11111111111111111111111100000000000000000000000000000000011111111111111111111111111111111111111111111111111111111111111111111111111
100100000000000000000011111111111111111111111111111111111100000000000000000000000000000000000000000000000000000000000000000000001111111
10
